##################################################
#                                                #
# P B                                            #
#                                                #
#                                      ####      #
#                             ######             #
#          ##         ##           #             #
#************************************************#
##################################################