##################################################
#                                                #
# P B                                            #
#                                                #
#                                      ###########
#                             ######             #
#          ##         ##                         #
#************************************************#
##################################################


