##################################################
#                                                #
# P B                                            #
#                                                #
#                                      ####      #
#                             ######             #
#          ##         ##           #             #
##################################################