######################################################
#            ##                                      #
# 	      					     #
# P B         ************  *********************** *#
#                                                #   #
#                         **           ##    #####   #
#                     **  ##  ######   ##        #   #
#          **       ####  ##           ###           #
#**********##************************************#   #
##################################################000#